1A1L1V1111111
10010X00000C1
1000011111001
1P0011E000001
1111111111111
