1111111111111
1C00000000001
1110011110001
1P1011E000001
1111111111111
