1111111111111
10010X0A000C1
1000011111001
1P0011E000001
1111111111111
