1111111111111
1E10101010101
1000000000001
111100P001111
1000000000001
10101010101C1
1111111111111
