1111111111111
1001000001001
1000011111001
1P0011E001001
1111111111111
