1111111111111
10000000000C1
1001000000001
1P1100E000001
1111111111111
