1111111111111
1C00000000001
1001000C00001
1P1100E000001
1111111111111
