111111111111111111111111111111111111111111111111111111111111
1E11C1000000000000000000000000000000000000000000000000000001
1P0000000000000000000000000000000000000000000000000000000001
100000000000000000000100CCCCCCCCCCCC000000000000000000000001
100000000000000000001100000000000000C00000000000000000000001
1000000000000000000101000000000000000C0000000000000000000001
10000000000000000010010000000000000000C000000000000000000001
10000000000000000100010000000000CCCCCCC000000000000000000001
10000000000000001000010000000000C000000000000000000000000001
100000000000000100000100000000CC0000000000000000000000000001
10000000000000111111110000000C000000000000000000000000000001
1000000000000000000001000000C0000000000000000000000000000001
100000000000000000000100000C00000000000000000000000000000001
10000000000000000000010000C000000000000000000000000000000001
1000000000000000000001000C0000000000000000000000000000000001
100000000000000000000100CCCCCCCCCCC0000000000000000000000001
100000000000000000000000000000000000000000000000000000000001
100000000000000000000000000000000000000000000000000000000001
100000000000000000000000000000000000000000000000000000000001
100000000000000000000000000000000000000000000000000000000001
100000000000000000000000000000000000000000000000000000000001
100000000000000000000000000000000000000000000000000000000001
100000000000000000000000000000000000000000000000000000000001
100000000000000000000000000000000000000000000000000000000001
100000000000000000000000000000000000000000000000000000000001
100000000000000000000000000000000000000000000000000000000001
100000000000000000000000000000000000000000000000000000000001
100000000000000000000000000000000000000000000000000000000001
100000000000000000000000000000000000000000000000000000000001
100000000000000000000000000000000000000000000000000000000001
100000000000000000000000000000000000000000000000000000000001
100000000000000000000000000000000000000000000000000000000001
111111111111111111111111111111111111111111111111111111111111
