1111111111111111111111111111111111111111
1E11C10000000000000000000000000000000001
1P00000000000000000000000000000000000001
100000000000000000000100CCCCCCCCCCCC0001
100000000000000000001100000000000000C001
1000000000000000000101000000000000000C01
10000000000000000010010000000000000000C1
10000000000000000100010000000000CCCCCCC1
10000000000000001000010000000000C0000001
100000000000000100000100000000CC00000001
10000000000000111111110000000C0000000001
1000000000000000000001000000C00000000001
100000000000000000000100000C000000000001
10000000000000000000010000C0000000000001
1000000000000000000001000C00000000000001
100000000000000000000100CCCCCCCCCCC00001
1000000000000000000000000000000000000001
1000000000000000000000000000000000000001
1000000000000000000000000000000000000001
1100000000000000000000000000000000000001
1111111111111111111111111111111111111111
